##################################################
#####        ############################ ########
    # ### ##                    ############# ####
  ### ####   %            ############### #########
##### ########         ################## ##########
####           **            ############ #########
#############       ##################### #####
#####   @@                    ########### ########
##################################################
##########################