    #####
    #   #
    #@ @#
  ###   ##
  #   @  #
### #@## #   ######
#   # ## #####  OO#
# @      P@     OO#
###### ### # ## OO#
     #     ########        
     #######