##################################################
#                   == Menu ==                   #
#                                                #
#                  > [P] Play                    #
#                  > [R] Record                  #
#                  > [E] Exit                    #
#                                                #
##################################################
